{
    "type": "domain_values",
    "name": "Dom Municipios",
    "pgsql_create_table_script": "dom_municipios.sql",
    "from_to_values": {
        "3200": 1,
        "4800": 2,
        "900": 3,
        "5000": 4,
        "6700": 5,
        "5900": 6,
        "4500": 7,
        "2200": 8,
        "6100": 9,
        "800": 10,
        "9200": 11,
        "1700": 12,
        "3300": 13,
        "5800": 14,
        "8000": 15,
        "3500": 16,
        "1200": 17,
        "6600": 18,
        "9600": 19,
        "2100": 20,
        "6200": 21,
        "9400": 22,
        "700": 23,
        "1600": 24,
        "4000": 25,
        "5700": 26,
        "3400": 27,
        "1100": 28,
        "6400": 29,
        "9000": 30,
        "2000": 31,
        "7800": 32,
        "2900": 33,
        "600": 34,
        "9700": 35,
        "5600": 36,
        "5200": 37,
        "9900": 38,
        "6500": 39,
        "1000": 40,
        "8400": 41,
        "6000": 42,
        "7400": 43,
        "500": 44,
        "1400": 45,
        "1300": 46,
        "5500": 47
    }
}